47,47
# # # ##### # ### ### ### # # ### ##### ### # #
  # #   #     # #   #       #     #   # #     #
# # # # ####### ### ################# # #######
#   # #       #     #     #           #     #  
# ########### # ##### ##### ####### ####### ###
# #     #   #   #     #   # #     #   #   # #  
### ### # # # ### ##### # # ### # ### # ### # #
#   #   # # #   # #   # # # #   # # # #     # #
# ### ### # ##### # # ### # # ### # # # ### # #
#   #   # #         #     #     #   #   #   #  
### ### # ############# ####### ######### # ###
  #   #     #       #         #   #     # # #  
##### ##### # ####### ########### ##### # # ###
      #   # #       # #   #       #   # # # #  
####### ### ####### # # # # ####### # # # # # #
        #   # #       # #   #       # # # #    
######### ### # ########### ######### # # #####
    #   #   # # #   #     #   #       #   #   #
# # # # ### # # # # # ### ### # ########### # #
# # # #   # #   # # #   #   #   #     #     # #
# ### ### # # ##### ### ### ##### # # # ##### #
      #     #       #   # # #     # #   # #   #
##### ############### ### # # ##### ### # # ###
  #   #   #         #     #   #   # # # #   #  
### ### ### ##### # ##### ##### # # # # ##### #
    #   #   #   # # #     #     # #   #     # #
# # # ### ### # # # # ##### ##### ### # ### ###
# # #   # #   #   # #   #   #   #   # # #   #  
### ### # # ####### # # # ##### ### # # # ### #
  #   # # #   #     # # # #   #   # # # # # # #
# ### # # ### ####### ### # # ### # ### # # # #
  #   # #   #     # #   #   #     #     # #   #
####### ### ### # # ### ######### ### ### # ###
#   #       #   #     #   # #   #   # # # #   #
# # # ####### ####### # # # # # ### # # # ### #
  # # # #   # #   #   # #   # # #   #   # # # #
# ### # # # # # # # ### ### # # # ##### # # # #
  #   # # # # # #   #   #   # # #   #   # #   #
### ### # # # # ##### ### ### # ### ##### #####
    #   # #   #   #   #   #   #   # #     #   #
##### ### ### ##### ####### ##### # # ##### ###
#   # #   # #       #       #     # # #   #    
# # # # ### ####### ### ##### ### ### # # ### #
  # # # #   #     #     #     # #   #   #   #  
##### # # # # # ####### # ##### ### ####### ###
  #   # # # # # #     # #       #         #   #
# # ### ### # # # ### # ######### ########### #